{
 "type": "map",
 "size": [15,10],
 "textures": [
  {
   "path": "textures/stone_slab_top.png",
   "tile_amount": 2.0
  }
 ],
 "map_data": [
  [1, 1, 1, 1, 1],
  [1, 0, 0, 0, 1, 1, 1, 1, 1],
  [1, 1, 1, 0, 1, 0, 0, 0, 1],
  [1, 0, 0, 0, 1, 0, 1, 1, 1],
  [1, 1, 1, 0, 1, 0, 1, 1, 1],
  [1, 0, 0, 0, 1, 0, 0, 0, 1],
  [1, 0, 1, 1, 1, 0, 1, 0, 1, 1],
  [1, 0, 1, 1, 1, 0, 1, 0, 0, 1],
  [1, 0, 0, 0, 0, 0, 1, 1, 1, 1],
  [1, 0, 1, 1, 1, 1, 1, 1, 1, 1],
  [1, 1, 1]
 ]
}